android.bluetooth.le.AdvertisingSet.enableAdvertising            	BLUETOOTH_ADVERTISE      	允许该应用向附近的蓝牙设备广播
android.bluetooth.le.AdvertisingSet.setAdvertisingData           	BLUETOOTH_ADVERTISE      	允许该应用向附近的蓝牙设备广播
android.bluetooth.le.AdvertisingSet.setAdvertisingParameters     	BLUETOOTH_ADVERTISE      	允许该应用向附近的蓝牙设备广播
android.bluetooth.le.AdvertisingSet.setPeriodicAdvertisingData   	BLUETOOTH_ADVERTISE      	允许该应用向附近的蓝牙设备广播
android.bluetooth.le.AdvertisingSet.setPeriodicAdvertisingEnabled	BLUETOOTH_ADVERTISE      	允许该应用向附近的蓝牙设备广播
android.bluetooth.le.AdvertisingSet.setPeriodicAdvertisingParameters	BLUETOOTH_ADVERTISE      	允许该应用向附近的蓝牙设备广播
android.bluetooth.le.AdvertisingSet.setScanResponseData          	BLUETOOTH_ADVERTISE      	允许该应用向附近的蓝牙设备广播
android.bluetooth.le.BluetoothLeAdvertiser.startAdvertising      	BLUETOOTH_ADVERTISE      	允许该应用向附近的蓝牙设备广播
android.bluetooth.le.BluetoothLeAdvertiser.startAdvertisingSet   	BLUETOOTH_ADVERTISE      	允许该应用向附近的蓝牙设备广播
android.bluetooth.le.BluetoothLeAdvertiser.stopAdvertising       	BLUETOOTH_ADVERTISE      	允许该应用向附近的蓝牙设备广播
android.bluetooth.le.BluetoothLeAdvertiser.stopAdvertisingSet    	BLUETOOTH_ADVERTISE      	允许该应用向附近的蓝牙设备广播
android.bluetooth.BluetoothAdapter.cancelDiscovery               	BLUETOOTH_SCAN           	允许该应用发现附近的蓝牙设备并与其配对
android.bluetooth.BluetoothAdapter.getScanMode                   	BLUETOOTH_SCAN           	允许该应用发现附近的蓝牙设备并与其配对
android.bluetooth.BluetoothAdapter.isDiscovering                 	BLUETOOTH_SCAN           	允许该应用发现附近的蓝牙设备并与其配对
android.bluetooth.BluetoothAdapter.startDiscovery                	BLUETOOTH_SCAN           	允许该应用发现附近的蓝牙设备并与其配对
android.bluetooth.BluetoothAdapter.startLeScan                   	BLUETOOTH_SCAN           	允许该应用发现附近的蓝牙设备并与其配对
android.bluetooth.BluetoothAdapter.stopLeScan                    	BLUETOOTH_SCAN           	允许该应用发现附近的蓝牙设备并与其配对
android.bluetooth.le.BluetoothLeScanner.flushPendingScanResults  	BLUETOOTH_SCAN           	允许该应用发现附近的蓝牙设备并与其配对
android.bluetooth.le.BluetoothLeScanner.startScan                	BLUETOOTH_SCAN           	允许该应用发现附近的蓝牙设备并与其配对
android.bluetooth.le.BluetoothLeScanner.stopScan                 	BLUETOOTH_SCAN           	允许该应用发现附近的蓝牙设备并与其配对
