android.app.admin.DevicePolicyManager.setPermissionGrantState    	ACCESS_BACKGROUND_LOCATION;ACCESS_COARSE_LOCATION;ACCESS_FINE_LOCATION;CAMERA;RECORD_AUDIO	即使您并未使用此应用，此应用也可以随时访问位置信息。;当您使用此应用时，此应用可以通过位置信息服务获取您的大致位置信息。您必须开启设备的位置信息服务，此应用才能获取位置信息。;当您使用此应用时，此应用可以通过位置信息服务获取您的确切位置信息。您必须开启设备的位置信息服务，此应用才能获取位置信息。这可能会增加耗电量。;此应用可以识别您的身体活动。;当您使用此应用时，它可以使用麦克风录音。
android.R.attr.usesPermissionFlags                               	ACCESS_COARSE_LOCATION;ACCESS_FINE_LOCATION	当您使用此应用时，此应用可以通过位置信息服务获取您的大致位置信息。您必须开启设备的位置信息服务，此应用才能获取位置信息。;当您使用此应用时，此应用可以通过位置信息服务获取您的确切位置信息。您必须开启设备的位置信息服务，此应用才能获取位置信息。这可能会增加耗电量。
android.bluetooth.le.BluetoothLeScanner.startScan                	ACCESS_COARSE_LOCATION;ACCESS_FINE_LOCATION	当您使用此应用时，此应用可以通过位置信息服务获取您的大致位置信息。您必须开启设备的位置信息服务，此应用才能获取位置信息。;当您使用此应用时，此应用可以通过位置信息服务获取您的确切位置信息。您必须开启设备的位置信息服务，此应用才能获取位置信息。这可能会增加耗电量。
android.location.LocationManager.addProximityAlert               	ACCESS_COARSE_LOCATION;ACCESS_FINE_LOCATION	当您使用此应用时，此应用可以通过位置信息服务获取您的大致位置信息。您必须开启设备的位置信息服务，此应用才能获取位置信息。;当您使用此应用时，此应用可以通过位置信息服务获取您的确切位置信息。您必须开启设备的位置信息服务，此应用才能获取位置信息。这可能会增加耗电量。
android.location.LocationManager.getCurrentLocation              	ACCESS_COARSE_LOCATION;ACCESS_FINE_LOCATION	当您使用此应用时，此应用可以通过位置信息服务获取您的大致位置信息。您必须开启设备的位置信息服务，此应用才能获取位置信息。;当您使用此应用时，此应用可以通过位置信息服务获取您的确切位置信息。您必须开启设备的位置信息服务，此应用才能获取位置信息。这可能会增加耗电量。
android.location.LocationManager.getLastKnownLocation            	ACCESS_COARSE_LOCATION;ACCESS_FINE_LOCATION	当您使用此应用时，此应用可以通过位置信息服务获取您的大致位置信息。您必须开启设备的位置信息服务，此应用才能获取位置信息。;当您使用此应用时，此应用可以通过位置信息服务获取您的确切位置信息。您必须开启设备的位置信息服务，此应用才能获取位置信息。这可能会增加耗电量。
android.location.LocationManager.removeProximityAlert            	ACCESS_COARSE_LOCATION;ACCESS_FINE_LOCATION	当您使用此应用时，此应用可以通过位置信息服务获取您的大致位置信息。您必须开启设备的位置信息服务，此应用才能获取位置信息。;当您使用此应用时，此应用可以通过位置信息服务获取您的确切位置信息。您必须开启设备的位置信息服务，此应用才能获取位置信息。这可能会增加耗电量。
android.location.LocationManager.removeUpdates                   	ACCESS_COARSE_LOCATION;ACCESS_FINE_LOCATION	当您使用此应用时，此应用可以通过位置信息服务获取您的大致位置信息。您必须开启设备的位置信息服务，此应用才能获取位置信息。;当您使用此应用时，此应用可以通过位置信息服务获取您的确切位置信息。您必须开启设备的位置信息服务，此应用才能获取位置信息。这可能会增加耗电量。
android.location.LocationManager.requestLocationUpdates          	ACCESS_COARSE_LOCATION;ACCESS_FINE_LOCATION	当您使用此应用时，此应用可以通过位置信息服务获取您的大致位置信息。您必须开启设备的位置信息服务，此应用才能获取位置信息。;当您使用此应用时，此应用可以通过位置信息服务获取您的确切位置信息。您必须开启设备的位置信息服务，此应用才能获取位置信息。这可能会增加耗电量。
android.location.LocationManager.requestSingleUpdate             	ACCESS_COARSE_LOCATION;ACCESS_FINE_LOCATION	当您使用此应用时，此应用可以通过位置信息服务获取您的大致位置信息。您必须开启设备的位置信息服务，此应用才能获取位置信息。;当您使用此应用时，此应用可以通过位置信息服务获取您的确切位置信息。您必须开启设备的位置信息服务，此应用才能获取位置信息。这可能会增加耗电量。
android.telephony.CellLocation.requestLocationUpdate             	ACCESS_COARSE_LOCATION;ACCESS_FINE_LOCATION	当您使用此应用时，此应用可以通过位置信息服务获取您的大致位置信息。您必须开启设备的位置信息服务，此应用才能获取位置信息。;当您使用此应用时，此应用可以通过位置信息服务获取您的确切位置信息。您必须开启设备的位置信息服务，此应用才能获取位置信息。这可能会增加耗电量。
android.telephony.PhoneStateListener.onServiceStateChanged       	ACCESS_COARSE_LOCATION;ACCESS_FINE_LOCATION	当您使用此应用时，此应用可以通过位置信息服务获取您的大致位置信息。您必须开启设备的位置信息服务，此应用才能获取位置信息。;当您使用此应用时，此应用可以通过位置信息服务获取您的确切位置信息。您必须开启设备的位置信息服务，此应用才能获取位置信息。这可能会增加耗电量。
android.telephony.ServiceState.getCdmaNetworkId                  	ACCESS_COARSE_LOCATION;ACCESS_FINE_LOCATION	当您使用此应用时，此应用可以通过位置信息服务获取您的大致位置信息。您必须开启设备的位置信息服务，此应用才能获取位置信息。;当您使用此应用时，此应用可以通过位置信息服务获取您的确切位置信息。您必须开启设备的位置信息服务，此应用才能获取位置信息。这可能会增加耗电量。
android.telephony.ServiceState.getCdmaSystemId                   	ACCESS_COARSE_LOCATION;ACCESS_FINE_LOCATION	当您使用此应用时，此应用可以通过位置信息服务获取您的大致位置信息。您必须开启设备的位置信息服务，此应用才能获取位置信息。;当您使用此应用时，此应用可以通过位置信息服务获取您的确切位置信息。您必须开启设备的位置信息服务，此应用才能获取位置信息。这可能会增加耗电量。
android.telephony.ServiceState.getOperatorAlphaLong              	ACCESS_COARSE_LOCATION;ACCESS_FINE_LOCATION	当您使用此应用时，此应用可以通过位置信息服务获取您的大致位置信息。您必须开启设备的位置信息服务，此应用才能获取位置信息。;当您使用此应用时，此应用可以通过位置信息服务获取您的确切位置信息。您必须开启设备的位置信息服务，此应用才能获取位置信息。这可能会增加耗电量。
android.telephony.ServiceState.getOperatorAlphaShort             	ACCESS_COARSE_LOCATION;ACCESS_FINE_LOCATION	当您使用此应用时，此应用可以通过位置信息服务获取您的大致位置信息。您必须开启设备的位置信息服务，此应用才能获取位置信息。;当您使用此应用时，此应用可以通过位置信息服务获取您的确切位置信息。您必须开启设备的位置信息服务，此应用才能获取位置信息。这可能会增加耗电量。
android.telephony.ServiceState.getOperatorNumeric                	ACCESS_COARSE_LOCATION;ACCESS_FINE_LOCATION	当您使用此应用时，此应用可以通过位置信息服务获取您的大致位置信息。您必须开启设备的位置信息服务，此应用才能获取位置信息。;当您使用此应用时，此应用可以通过位置信息服务获取您的确切位置信息。您必须开启设备的位置信息服务，此应用才能获取位置信息。这可能会增加耗电量。
android.telephony.TelephonyCallback.ServiceStateListener.onServiceStateChanged	ACCESS_COARSE_LOCATION;ACCESS_FINE_LOCATION	当您使用此应用时，此应用可以通过位置信息服务获取您的大致位置信息。您必须开启设备的位置信息服务，此应用才能获取位置信息。;当您使用此应用时，此应用可以通过位置信息服务获取您的确切位置信息。您必须开启设备的位置信息服务，此应用才能获取位置信息。这可能会增加耗电量。
android.telephony.TelephonyManager.getServiceState               	ACCESS_COARSE_LOCATION   	当您使用此应用时，此应用可以通过位置信息服务获取您的大致位置信息。您必须开启设备的位置信息服务，此应用才能获取位置信息。
android.webkit.WebSettings.setGeolocationEnabled                 	ACCESS_COARSE_LOCATION;ACCESS_FINE_LOCATION	当您使用此应用时，此应用可以通过位置信息服务获取您的大致位置信息。您必须开启设备的位置信息服务，此应用才能获取位置信息。;当您使用此应用时，此应用可以通过位置信息服务获取您的确切位置信息。您必须开启设备的位置信息服务，此应用才能获取位置信息。这可能会增加耗电量。
android.bluetooth.BluetoothAdapter.startDiscovery                	ACCESS_FINE_LOCATION     	当您使用此应用时，此应用可以通过位置信息服务获取您的确切位置信息。您必须开启设备的位置信息服务，此应用才能获取位置信息。这可能会增加耗电量。
android.bluetooth.BluetoothAdapter.startLeScan                   	ACCESS_FINE_LOCATION     	当您使用此应用时，此应用可以通过位置信息服务获取您的确切位置信息。您必须开启设备的位置信息服务，此应用才能获取位置信息。这可能会增加耗电量。
android.location.LocationManager.addGpsStatusListener            	ACCESS_FINE_LOCATION     	当您使用此应用时，此应用可以通过位置信息服务获取您的确切位置信息。您必须开启设备的位置信息服务，此应用才能获取位置信息。这可能会增加耗电量。
android.location.LocationManager.addNmeaListener                 	ACCESS_FINE_LOCATION     	当您使用此应用时，此应用可以通过位置信息服务获取您的确切位置信息。您必须开启设备的位置信息服务，此应用才能获取位置信息。这可能会增加耗电量。
android.location.LocationManager.getGpsStatus                    	ACCESS_FINE_LOCATION     	当您使用此应用时，此应用可以通过位置信息服务获取您的确切位置信息。您必须开启设备的位置信息服务，此应用才能获取位置信息。这可能会增加耗电量。
android.location.LocationManager.registerAntennaInfoListener     	ACCESS_FINE_LOCATION     	当您使用此应用时，此应用可以通过位置信息服务获取您的确切位置信息。您必须开启设备的位置信息服务，此应用才能获取位置信息。这可能会增加耗电量。
android.location.LocationManager.registerGnssMeasurementsCallback	ACCESS_FINE_LOCATION     	当您使用此应用时，此应用可以通过位置信息服务获取您的确切位置信息。您必须开启设备的位置信息服务，此应用才能获取位置信息。这可能会增加耗电量。
android.location.LocationManager.registerGnssNavigationMessageCallback	ACCESS_FINE_LOCATION     	当您使用此应用时，此应用可以通过位置信息服务获取您的确切位置信息。您必须开启设备的位置信息服务，此应用才能获取位置信息。这可能会增加耗电量。
android.location.LocationManager.registerGnssStatusCallback      	ACCESS_FINE_LOCATION     	当您使用此应用时，此应用可以通过位置信息服务获取您的确切位置信息。您必须开启设备的位置信息服务，此应用才能获取位置信息。这可能会增加耗电量。
android.net.NetworkCapabilities.getOwnerUid                      	ACCESS_FINE_LOCATION     	当您使用此应用时，此应用可以通过位置信息服务获取您的确切位置信息。您必须开启设备的位置信息服务，此应用才能获取位置信息。这可能会增加耗电量。
android.net.wifi.WifiInfo.getMacAddress                          	ACCESS_FINE_LOCATION     	当您使用此应用时，此应用可以通过位置信息服务获取您的确切位置信息。您必须开启设备的位置信息服务，此应用才能获取位置信息。这可能会增加耗电量。
android.net.wifi.WifiManager.addNetworkSuggestions               	ACCESS_FINE_LOCATION     	当您使用此应用时，此应用可以通过位置信息服务获取您的确切位置信息。您必须开启设备的位置信息服务，此应用才能获取位置信息。这可能会增加耗电量。
android.net.wifi.WifiManager.addSuggestionConnectionStatusListener	ACCESS_FINE_LOCATION     	当您使用此应用时，此应用可以通过位置信息服务获取您的确切位置信息。您必须开启设备的位置信息服务，此应用才能获取位置信息。这可能会增加耗电量。
android.net.wifi.WifiManager.getConfiguredNetworks               	ACCESS_FINE_LOCATION     	当您使用此应用时，此应用可以通过位置信息服务获取您的确切位置信息。您必须开启设备的位置信息服务，此应用才能获取位置信息。这可能会增加耗电量。
android.net.wifi.WifiManager.getScanResults                      	ACCESS_FINE_LOCATION     	当您使用此应用时，此应用可以通过位置信息服务获取您的确切位置信息。您必须开启设备的位置信息服务，此应用才能获取位置信息。这可能会增加耗电量。
android.net.wifi.WifiManager.registerScanResultsCallback         	ACCESS_FINE_LOCATION     	当您使用此应用时，此应用可以通过位置信息服务获取您的确切位置信息。您必须开启设备的位置信息服务，此应用才能获取位置信息。这可能会增加耗电量。
android.net.wifi.WifiManager.startLocalOnlyHotspot               	ACCESS_FINE_LOCATION     	当您使用此应用时，此应用可以通过位置信息服务获取您的确切位置信息。您必须开启设备的位置信息服务，此应用才能获取位置信息。这可能会增加耗电量。
android.net.wifi.aware.IdentityChangedListener.onIdentityChanged 	ACCESS_FINE_LOCATION     	当您使用此应用时，此应用可以通过位置信息服务获取您的确切位置信息。您必须开启设备的位置信息服务，此应用才能获取位置信息。这可能会增加耗电量。
android.net.wifi.aware.WifiAwareManager.attach                   	ACCESS_FINE_LOCATION     	当您使用此应用时，此应用可以通过位置信息服务获取您的确切位置信息。您必须开启设备的位置信息服务，此应用才能获取位置信息。这可能会增加耗电量。
android.net.wifi.aware.WifiAwareSession.publish                  	ACCESS_FINE_LOCATION     	当您使用此应用时，此应用可以通过位置信息服务获取您的确切位置信息。您必须开启设备的位置信息服务，此应用才能获取位置信息。这可能会增加耗电量。
android.net.wifi.aware.WifiAwareSession.subscribe                	ACCESS_FINE_LOCATION     	当您使用此应用时，此应用可以通过位置信息服务获取您的确切位置信息。您必须开启设备的位置信息服务，此应用才能获取位置信息。这可能会增加耗电量。
android.net.wifi.p2p.WifiP2pManager.addLocalService              	ACCESS_FINE_LOCATION     	当您使用此应用时，此应用可以通过位置信息服务获取您的确切位置信息。您必须开启设备的位置信息服务，此应用才能获取位置信息。这可能会增加耗电量。
android.net.wifi.p2p.WifiP2pManager.connect                      	ACCESS_FINE_LOCATION     	当您使用此应用时，此应用可以通过位置信息服务获取您的确切位置信息。您必须开启设备的位置信息服务，此应用才能获取位置信息。这可能会增加耗电量。
android.net.wifi.p2p.WifiP2pManager.createGroup                  	ACCESS_FINE_LOCATION     	当您使用此应用时，此应用可以通过位置信息服务获取您的确切位置信息。您必须开启设备的位置信息服务，此应用才能获取位置信息。这可能会增加耗电量。
android.net.wifi.p2p.WifiP2pManager.discoverPeers                	ACCESS_FINE_LOCATION     	当您使用此应用时，此应用可以通过位置信息服务获取您的确切位置信息。您必须开启设备的位置信息服务，此应用才能获取位置信息。这可能会增加耗电量。
android.net.wifi.p2p.WifiP2pManager.discoverServices             	ACCESS_FINE_LOCATION     	当您使用此应用时，此应用可以通过位置信息服务获取您的确切位置信息。您必须开启设备的位置信息服务，此应用才能获取位置信息。这可能会增加耗电量。
android.net.wifi.p2p.WifiP2pManager.requestDeviceInfo            	ACCESS_FINE_LOCATION     	当您使用此应用时，此应用可以通过位置信息服务获取您的确切位置信息。您必须开启设备的位置信息服务，此应用才能获取位置信息。这可能会增加耗电量。
android.net.wifi.p2p.WifiP2pManager.requestGroupInfo             	ACCESS_FINE_LOCATION     	当您使用此应用时，此应用可以通过位置信息服务获取您的确切位置信息。您必须开启设备的位置信息服务，此应用才能获取位置信息。这可能会增加耗电量。
android.net.wifi.p2p.WifiP2pManager.requestPeers                 	ACCESS_FINE_LOCATION     	当您使用此应用时，此应用可以通过位置信息服务获取您的确切位置信息。您必须开启设备的位置信息服务，此应用才能获取位置信息。这可能会增加耗电量。
android.net.wifi.rtt.WifiRttManager.startRanging                 	ACCESS_FINE_LOCATION     	当您使用此应用时，此应用可以通过位置信息服务获取您的确切位置信息。您必须开启设备的位置信息服务，此应用才能获取位置信息。这可能会增加耗电量。
android.telephony.NetworkRegistrationInfo.getCellIdentity        	ACCESS_FINE_LOCATION     	当您使用此应用时，此应用可以通过位置信息服务获取您的确切位置信息。您必须开启设备的位置信息服务，此应用才能获取位置信息。这可能会增加耗电量。
android.telephony.PhoneStateListener.onBarringInfoChanged        	ACCESS_FINE_LOCATION     	当您使用此应用时，此应用可以通过位置信息服务获取您的确切位置信息。您必须开启设备的位置信息服务，此应用才能获取位置信息。这可能会增加耗电量。
android.telephony.PhoneStateListener.onCellInfoChanged           	ACCESS_FINE_LOCATION     	当您使用此应用时，此应用可以通过位置信息服务获取您的确切位置信息。您必须开启设备的位置信息服务，此应用才能获取位置信息。这可能会增加耗电量。
android.telephony.PhoneStateListener.onCellLocationChanged       	ACCESS_FINE_LOCATION     	当您使用此应用时，此应用可以通过位置信息服务获取您的确切位置信息。您必须开启设备的位置信息服务，此应用才能获取位置信息。这可能会增加耗电量。
android.telephony.PhoneStateListener.onRegistrationFailed        	ACCESS_FINE_LOCATION     	当您使用此应用时，此应用可以通过位置信息服务获取您的确切位置信息。您必须开启设备的位置信息服务，此应用才能获取位置信息。这可能会增加耗电量。
android.telephony.TelephonyCallback.BarringInfoListener.onBarringInfoChanged	ACCESS_FINE_LOCATION     	当您使用此应用时，此应用可以通过位置信息服务获取您的确切位置信息。您必须开启设备的位置信息服务，此应用才能获取位置信息。这可能会增加耗电量。
android.telephony.TelephonyCallback.CellInfoListener.onCellInfoChanged	ACCESS_FINE_LOCATION     	当您使用此应用时，此应用可以通过位置信息服务获取您的确切位置信息。您必须开启设备的位置信息服务，此应用才能获取位置信息。这可能会增加耗电量。
android.telephony.TelephonyCallback.CellLocationListener.onCellLocationChanged	ACCESS_FINE_LOCATION     	当您使用此应用时，此应用可以通过位置信息服务获取您的确切位置信息。您必须开启设备的位置信息服务，此应用才能获取位置信息。这可能会增加耗电量。
android.telephony.TelephonyCallback.RegistrationFailedListener.onRegistrationFailed	ACCESS_FINE_LOCATION     	当您使用此应用时，此应用可以通过位置信息服务获取您的确切位置信息。您必须开启设备的位置信息服务，此应用才能获取位置信息。这可能会增加耗电量。
android.telephony.TelephonyManager.getAllCellInfo                	ACCESS_FINE_LOCATION     	当您使用此应用时，此应用可以通过位置信息服务获取您的确切位置信息。您必须开启设备的位置信息服务，此应用才能获取位置信息。这可能会增加耗电量。
android.telephony.TelephonyManager.getCellLocation               	ACCESS_FINE_LOCATION     	当您使用此应用时，此应用可以通过位置信息服务获取您的确切位置信息。您必须开启设备的位置信息服务，此应用才能获取位置信息。这可能会增加耗电量。
android.telephony.TelephonyManager.requestCellInfoUpdate         	ACCESS_FINE_LOCATION     	当您使用此应用时，此应用可以通过位置信息服务获取您的确切位置信息。您必须开启设备的位置信息服务，此应用才能获取位置信息。这可能会增加耗电量。
android.telephony.TelephonyManager.requestNetworkScan            	ACCESS_FINE_LOCATION     	当您使用此应用时，此应用可以通过位置信息服务获取您的确切位置信息。您必须开启设备的位置信息服务，此应用才能获取位置信息。这可能会增加耗电量。
android.hardware.camera2.CameraCharacteristics.getKeysNeedingPermission	CAMERA                   	此应用可以识别您的身体活动。
android.hardware.camera2.CameraManager.getCameraCharacteristics  	CAMERA                   	此应用可以识别您的身体活动。
android.hardware.camera2.CameraManager.isConcurrentSessionConfigurationSupported	CAMERA                   	此应用可以识别您的身体活动。
android.hardware.camera2.CameraManager.openCamera                	CAMERA                   	此应用可以识别您的身体活动。
android.hardware.usb.UsbManager.hasPermission                    	CAMERA                   	此应用可以识别您的身体活动。
android.hardware.usb.UsbManager.requestPermission                	CAMERA                   	此应用可以识别您的身体活动。
android.app.WallpaperManager.getDrawable                         	READ_EXTERNAL_STORAGE    	允许该应用读取您共享存储空间中的内容。
android.app.WallpaperManager.getFastDrawable                     	READ_EXTERNAL_STORAGE    	允许该应用读取您共享存储空间中的内容。
android.app.WallpaperManager.getWallpaperFile                    	READ_EXTERNAL_STORAGE    	允许该应用读取您共享存储空间中的内容。
android.app.WallpaperManager.peekFastDrawable                    	READ_EXTERNAL_STORAGE    	允许该应用读取您共享存储空间中的内容。
android.content.Context.getExternalCacheDir                      	READ_EXTERNAL_STORAGE;WRITE_EXTERNAL_STORAGE	允许该应用读取您共享存储空间中的内容。;允许该应用写入您共享存储空间中的内容。
android.content.Context.getExternalFilesDir                      	READ_EXTERNAL_STORAGE;WRITE_EXTERNAL_STORAGE	允许该应用读取您共享存储空间中的内容。;允许该应用写入您共享存储空间中的内容。
android.content.Context.getObbDir                                	READ_EXTERNAL_STORAGE;WRITE_EXTERNAL_STORAGE	允许该应用读取您共享存储空间中的内容。;允许该应用写入您共享存储空间中的内容。
android.content.ContextWrapper.getExternalCacheDir               	READ_EXTERNAL_STORAGE;WRITE_EXTERNAL_STORAGE	允许该应用读取您共享存储空间中的内容。;允许该应用写入您共享存储空间中的内容。
android.content.ContextWrapper.getExternalFilesDir               	READ_EXTERNAL_STORAGE;WRITE_EXTERNAL_STORAGE	允许该应用读取您共享存储空间中的内容。;允许该应用写入您共享存储空间中的内容。
android.content.ContextWrapper.getObbDir                         	READ_EXTERNAL_STORAGE;WRITE_EXTERNAL_STORAGE	允许该应用读取您共享存储空间中的内容。;允许该应用写入您共享存储空间中的内容。
android.media.RingtoneManager.getCursor                          	READ_EXTERNAL_STORAGE    	允许该应用读取您共享存储空间中的内容。
android.media.RingtoneManager.getValidRingtoneUri                	READ_EXTERNAL_STORAGE    	允许该应用读取您共享存储空间中的内容。
android.os.Environment.getExternalStorageDirectory               	READ_EXTERNAL_STORAGE;WRITE_EXTERNAL_STORAGE	允许该应用读取您共享存储空间中的内容。;允许该应用写入您共享存储空间中的内容。
android.os.StrictMode.VmPolicy.Builder.detectFileUriExposure     	READ_EXTERNAL_STORAGE    	允许该应用读取您共享存储空间中的内容。
android.os.storage.StorageVolume.createAccessIntent              	READ_EXTERNAL_STORAGE;WRITE_EXTERNAL_STORAGE	允许该应用读取您共享存储空间中的内容。;允许该应用写入您共享存储空间中的内容。
android.test.mock.MockContext.getExternalCacheDir                	READ_EXTERNAL_STORAGE;WRITE_EXTERNAL_STORAGE	允许该应用读取您共享存储空间中的内容。;允许该应用写入您共享存储空间中的内容。
android.test.mock.MockContext.getExternalFilesDir                	READ_EXTERNAL_STORAGE;WRITE_EXTERNAL_STORAGE	允许该应用读取您共享存储空间中的内容。;允许该应用写入您共享存储空间中的内容。
android.test.mock.MockContext.getObbDir                          	READ_EXTERNAL_STORAGE;WRITE_EXTERNAL_STORAGE	允许该应用读取您共享存储空间中的内容。;允许该应用写入您共享存储空间中的内容。
android.media.AudioRecord.Builder.build                          	RECORD_AUDIO             	当您使用此应用时，它可以使用麦克风录音。
android.net.sip.SipAudioCall.startAudio                          	RECORD_AUDIO             	当您使用此应用时，它可以使用麦克风录音。
android.app.DownloadManager.Request.setDestinationInExternalPublicDir	WRITE_EXTERNAL_STORAGE   	允许该应用写入您共享存储空间中的内容。
android.app.DownloadManager.Request.setDestinationUri            	WRITE_EXTERNAL_STORAGE   	允许该应用写入您共享存储空间中的内容。
android.content.Context.getExternalCacheDirs                     	WRITE_EXTERNAL_STORAGE   	允许该应用写入您共享存储空间中的内容。
android.content.Context.getExternalFilesDirs                     	WRITE_EXTERNAL_STORAGE   	允许该应用写入您共享存储空间中的内容。
android.content.Context.getExternalMediaDirs                     	WRITE_EXTERNAL_STORAGE   	允许该应用写入您共享存储空间中的内容。
android.content.Context.getObbDirs                               	WRITE_EXTERNAL_STORAGE   	允许该应用写入您共享存储空间中的内容。
android.content.ContextWrapper.getExternalCacheDirs              	WRITE_EXTERNAL_STORAGE   	允许该应用写入您共享存储空间中的内容。
android.content.ContextWrapper.getExternalFilesDirs              	WRITE_EXTERNAL_STORAGE   	允许该应用写入您共享存储空间中的内容。
android.content.ContextWrapper.getExternalMediaDirs              	WRITE_EXTERNAL_STORAGE   	允许该应用写入您共享存储空间中的内容。
android.content.ContextWrapper.getObbDirs                        	WRITE_EXTERNAL_STORAGE   	允许该应用写入您共享存储空间中的内容。
android.test.mock.MockContext.getExternalCacheDirs               	WRITE_EXTERNAL_STORAGE   	允许该应用写入您共享存储空间中的内容。
android.test.mock.MockContext.getExternalFilesDirs               	WRITE_EXTERNAL_STORAGE   	允许该应用写入您共享存储空间中的内容。
android.test.mock.MockContext.getExternalMediaDirs               	WRITE_EXTERNAL_STORAGE   	允许该应用写入您共享存储空间中的内容。
android.test.mock.MockContext.getObbDirs                         	WRITE_EXTERNAL_STORAGE   	允许该应用写入您共享存储空间中的内容。
